                                        
    XXXXXXXXXXXXXXXXXXXXXXXXXXXXXXXX    
    X                              X    
    X                              X    
    X                              X    
    X                              X    
    X                              X    
    X                              X    
    XXXXXXXXXXX   XXXXXXXXXXXXXXXXXX    
         X              X               
         X              XXXXXXX         
         X                    X         
         X              X     X         
         X              X     X         
         XXXXXXXXXXXXXXXX     X         
                     X        X         
                     X        X         
                     X        X         
                     XXXXXXXXXX         
                                        